0 1 0 0 0
0 2 0 3 0
0 0 0 2 1
4 5 0 6 0
0 0 0 0 7